5
0 2 4 1 0
2 0 0 0 3
4 0 0 2 1
1 0 2 0 0
0 3 1 0 0